F 0,0,255
C 255,255,000

NO textures/wall_n.png
SO textures/wall_s.png
WE textures/wall_w.png
EA textures/wall_e.png

111111111
1000000011
10011111111
100000E0001
11111111111